['g', 'g', 'g', 'g', 'g', 'g', 'g', 'g', 'g', '.', 'W', 'g', 't', 't', 'gk','g', 't', 'g', 'g', 'g', ],
['S', 'S', 'S', 'S', 'S', 'S', 'g', 'g', 'g', 'g', 'W', 'g', 't', ';', 't', 't', 't', 'g', 'g', 'g', ],
['S', 'wa','w', 'w', 'w', 'S', 'g', 'g', 'g', 'W', 'W', 'g', 't', 't', 't', 't', 't', 't', 'g', 'g', ],
['S', 'w', 'w', 'w', 'w', 'S', 'g', 'g', 'W', 'W', 'g', 'g', 't', 't', 't', 't', 't', 'g', 'g', 'g', ],
['S', 'S', 'S', 'wd','S', 'S', 'g', 'g', 'W', 'g', 'g', 't', 't', 't', 'g', 'g', 'g', 'g', 'g', 'g', ],
['g', 'g', ',', '_', 'g', 'g', 'g', 'W', 'W', 'W', 'g', 't', 'g', 'g', 'g', 'g', 'g', 'g', 'g', 'g', ],
['.', 'g', 'g', '_', 'g', 'g', 'g', 'W', 'g', 'Wb','.', 'g', 'g', 'g', 'g', 'g', 'g', 'g', 'g', 'g', ],
['_', '_', '_', '_', 'g', 'g', 'W', 'W', 'g', 'W', 'W', 'g', 'g', 'g', 'g', '_', '_', '_', '_', '_', ],
['_', 'g', 't', 't', 'g', 'W', 'W', 'W', 'g', 'g', 'W', 'g', 'g', 'g', 'g', '_', 'g', 'g', 'g', 'g', ],
['_', 'g', 'g', 't', 'g', 'W', 'W', 'g', 'g', 'g', 'W', 'g', 'g', 'g', 'B', 'fD','B', 'g', 'g', 'g', ],
['_', 'g', 'g', 'g', 'g', 'g', 'g', 'g', 'g', 'g', 'W', 'W', 'g', 'g', 'B', 'f', 'B', '.', 'g', 'g', ],
['_', 'g', 'g', 'g', 'g', 'g', 't', 't', 'g', 'W', 'W', 'g', 'g', 'B', 'B', 'f', 'B', 'B', 'g', 'g', ],
['_', 'g', 'g', 'g', 'g', 'g', 't', 'g', 'g', 'W', ',', 'g', 'g', 'B', 'f', 'f', 'f', 'B', 'g', 'g', ],
['_', 'g', 'g', 'g', 'g', 'g', 'g', 'g', 'g', 'W', 'W', 'g', 'g', 'B', 'f', 'fh','f', 'B', 'g', 'g', ],
['_', '_', 'g', 'g', 'g', 'g', 'g', 'g', 'W', '.', 'W', 'g', 'g', 'B', 'f', 'f', 'f', 'B', 'g', 'g', ],
['g', '_', '_', 'g', 'g', 'g', 'g', 'W', 'W', 'g', 'W', 'g', 'g', 'B', 'B', 'B', 'B', 'B', 'g', 'g', ],
['g', 'g', '_', 'g', 'g', 'g', 'g', 'W', 'gc','g', 'W', 'g', 'g', 'g', 'g', 'g', 'g', 'g', 'g', 'g', ],
['g', 'g', '_', 'g', 'g', 'g', 'W', 'W', 'g', 'g', 'W', 'W', 'g', 'g', ':', 'g', 'g', 'g', 'g', 'g', ],
['g', 'g', 'g', 'g', 'g', 'W', 'W', 'W', 'g', 'g', 'W', 'W', 'g', 'g', 'g', 'g', 't', 'g', 'g', 'g', ],
['g', 'g', 'g', 'g', 'g', 'g', 'g', 'g', 'g', 'g', 'W', 'g', 'g', 'g', 'g', 'g', 'g', 'g', 'g', 'g', ],